|-----------------------------------------------------------------------------|
|                                                                             |
| |--------------|                   |-----------------------|                |
| |..............|                   |.......................|                |
| |..............+###################+.......................|                |
| |..............|     #             |.......................|                |
| |--+-----------|     #             |------+----------------|                |
|    #                 #                    #                                 |
|    #                 #                    #########                         |
| |--+-----------|     #                            #                         |
| |..............|     #      |---------------------+-----|                   |
| |..............+######      |...........................|                   |
| |..............|            |...........................|------------|      |
| |..............|            |........................................|      |
| |..............|            |-------------|..........................|      |
| |..............|                          |..........................|      |
| |..............|                          |..........................|      |
| |..............+##########################+.............|------------|      |
| |-------+------|                          |.............|                   |
|         ####                              |.............|                   |
|   |--------+--------------------------|   |------+------|                   |
|   |...................................|          #                          |
|   |...................................+###########                          |
|   |-----------------------------------|                                     |
|-----------------------------------------------------------------------------|
